%%%%%%%%%%%%%%%%%%%%%%%%
% P..   ........   ..  %
%....   ..       ....  %
%  ..   ..         ..  %
%  ..   ..         ..  %
%  ..   .......    ..  %
%  ..         ..   ..  %
%  ..         ..   ..  %
%  ..   ..   ..    .. G%
%......  .....   .....o%
%%%%%%%%%%%%%%%%%%%%%%%%